AAAAAAAAAAAAAAAAAAAAAAAAAAAAAAAAAAAAAAAA
ABBBBBBBBBBBBBBBBBBBBBBBBBBBBBBBBBBBBBBA
ABBBBBBBBBBBBBBBBBBBBBBBBBBBBBBBBBBBBBBA
ABBBBBAAAAABBBBBBBBBBBBBBAAAAABBBBBBBBBA
ABBBBBAAAAABBBBBBBBBBBBBBAAAAABBBBBBBBBA
ABBBBBAAAAABBBBBBBBBBBBBBAAAAABBBBBBBBBA
ABBBBBAAAAABBBBBBBBBBBBBBAAAAABBBBBBBBBA
ABBBBBAAAAABBBBBBBBBBBBBBAAAAABBBBBBBBBA
ABBBBBBBBBBBBBBBBBBBBBBBBBBBBBBBBBBBBBBA
ABBBBBBBBBBBBBBBBBBBBBBBBBBBBBBBBBBBBBBA
ABBBBBBBBBBBBBBBBBBBBBBBBBBBBBBBBBBBBBBA
ABBBBBBBBBBBBBBBBBBBBBBBBBBBBBBBBBBBBBBA
ABBBBBAAAAABBBBBBBBBBBBBBAAAAABBBBBBBBBA
ABBBBBAAAAABBBBBBBBBBBBBBAAAAABBBBBBBBBA
ABBBBBAAAAABBBBBBBBBBBBBBAAAAABBBBBBBBBA
ABBBBBAAAAABBBBBBBBBBBBBBAAAAABBBBBBBBBA
AAAAAAAAAAAAAAAABBAAAAAAAAAAAAAAAAAAAAAA
AAAAAAAAAAAAAAAABBAAAAAAAAAAAAAAAAAAAAAA
ABBBBBBBBBBBBBBBBBBBBBBBBBBBBBBBBBBBBBBA
ABBBBBBBBBBBBBBBBBBBBBBBBBBBBBBBBBBBBBBA
ABBBBBAAAAABBBBBBBBBBBBBBAAAAABBBBBBBBBA
ABBBBBAAAAABBBBBBBBBBBBBBAAAAABBBBBBBBBA
ABBBBBAAAAABBBBBBBBBBBBBBAAAAABBBBBBBBBA
ABBBBBAAAAABBBBBBBBBBBBBBAAAAABBBBBBBBBA
ABBBBBAAAAABBBBBBBBBBBBBBAAAAABBBBBBBBBA
ABBBBBBBBBBBBBBBBBBBBBBBBBBBBBBBBBBBBBBA
ABBBBBBBBBBBBBBBBBBBBBBBBBBBBBBBBBBBBBBA
ABBBBBBBBBBBBBBBBBBBBBBBBBBBBBBBBBBBBBBA
ABBBBBBBBBBBBBBBBBBBBBBBBBBBBBBBBBBBBBBA
ABBBBBAAAAABBBBBBBBBBBBBBAAAAABBBBBBBBBA
ABBBBBAAAAABBBBBBBBBBBBBBAAAAABBBBBBBBBA
ABBBBBAAAAABBBBBBBBBBBBBBAAAAABBBBBBBBBA
ABBBBBAAAAABBBBBBBBBBBBBBAAAAABBBBBBBBBA
AAAAAAAAAAAAAAABBBAAAAAAAAAAAAAAAAAAAAAA
AAAAAAAAAAAAAAABBBAAAAAAAAAAAAAAAAAAAAAA
ABBBBBBBBBBBBBBBBBBBBBBBBBBBBBBBBBBBBBBA
ABBBBBBBBBBBBBBBBBBBBBBBBBBBBBBBBBBBBBBA
ABBBBBAAAAABBBBBBBBBBBBBBAAAAABBBBBBBBBA
ABBBBBAAAAABBBBBBBBBBBBBBAAAAABBBBBBBBBA
AAAAAAAAAAAAAAAAAAAAAAAAAAAAAAAAAAAAAAAA